{
  "dimensions": {"width": 600, "height": 600},

  "data": [
	  [1,1,1,1,8,2,2,0],
	  [0,0,0,8,2,4,0,1],
	  [1,1,0,2,4,0,0,1],
	  [7,1,0,0,8,5,1,0],
	  [0,0,0,1,2,4,0,1],
	  [0,1,0,8,1,0,0,1],
	  [0,1,0,0,1,2,1,0],
	  [0,0,0,1,2,1,0,1],
	  [1,2,0,8,1,0,0,1],
	  [1,1,1,1,2,1,1,0],
	  [1,0,0,1,1,1,0,1],
	  [1,1,0,1,1,0,0,1],
	  [2,1,0,0,1,1,1,0],
	  [1,0,0,2,0,1,0,1],
	  [1,1,0,1,1,0,0,1],
	  [1,1,1,0,1,1,1,0],
	  [1,0,0,1,1,1,0,1],
	  [3,3,3,3,3,3,3,3]
  ]
}